"achievement_LVL_FACTION_FIRESTARTERS_name"	"Pyromancer"
"achievement_LVL_PARAGON_FIRESTARTERS_name"	"Z patelni na ogień"
"ambulance01_bundle_vehicle_name"	"Ostatnia pomoc"
"avatar_default_name"	"Kai"
"Blockpost_Defeat_nomads_text3"	"Przekarzę tragiczne wiadomości o twoim zgonie twojej rodzinie... nic sie nie martw."
"Blockpost_Defeat_psycho_text"	"Raz, dwa, trzy, cztery - I już gryzą glebe!"
"Blockpost_Defeat_psycho_text3"	"Raz, dwa, i go nie ma!"
"Blockpost_Defeat_scavengers_text"	"Dostałeś po łapach? zabieranie naszego towaru to czysta głupota!"
"Blockpost_Defeat_scavengers_text2"	"Było nasze, wasze, a teraz znowu nasze. Ha! nie zabieraj tego co nie twoje!"
"Blockpost_psycho_caption"	"Lewis"
"Blockpost_scavengers_caption"	"Dozer"
"BLUEPRINT_EXHIBITION_TOOLTIP"	"Podziel się schematem pojazdu na wystawie, niechaj inni ocenią oraz skopiują twoją kreacje"
"BLUEPRINT_LOAD_TOOLTIP"	"Złóż pojazd bojowy z części dostępnych w magazynie"
"Bombrun_nomads_caption"	"Jeff"
"Bombrun_scavengers_caption"	"Thermite"
"Captcha_text_2"	"Pozostało prób: $val$."
"CarDriver_Firestarters_lvl12_desc"	"$targets$: Obrażenia +$damage_mul$%"
"CarDriver_Firestarters_lvl13_desc"	"$targets$: amunicja +$ammo_add$ pcs."
"CarDriver_Firestarters_lvl7_desc"	"$targets$: obrażenia +$damage_mul$%"
"CarPart_Shnekohod_Desc"	"Zadziwiąjący sposób transportu, dwie śróby stworzone przez pewnego Archimedesa, każda śróba zmniejsza siłę kabiny ale pozwala na poruszanię się bokiem."
"CHAT_PUNISHED_player_ban"	"$accusedNickname$ został zablokowany za $reason$ do $until$ UTC."
"CHAT_PUNISHED_player_mute"	"$accusedNickname$ został wyciszony za $reason$ do $until$ UTC."
"ChestOpen_accept"	"Odbierz"
"ChestOpen_reroll"	"Zwróć za $cost$"
"ChestOpen_reroll_confirmation"	"Czy na pewno chcesz losować inną nagrodę?"
"Commtowers_psycho_caption"	"Munch"
"Decal_nyear2018_bow_Name"	"Wstęga"
"driverswnd_skills"	"Umiejętności:"
"ERROR_ANOTHER_CHEST_OPENED"	"Inna skrzynka zostałą otwarta, proszę odebrać jej zawartość"
"ERROR_NO_CHEST_OPENED"	"Próba losowania nie powiodła się, skrzynka nie jest jeszcze otwarta"
"ERROR_NO_REROLL_COST"	"Brak dodatkowych prób losowania nagrody."
"ERROR_WRONG_ROLL_COUNT"	"Brak dodatkowych prób losowania nagrody."
"EventNotificationWnd_quests"	"Gotowe zadania"
"EXHIBITION_HAVE_PARTS"	"Można zbudować"
"FACTION_CRAFT_CHEST_CONTENT"	"Możliwa zawartość"
"FACTION_CRAFT_CHEST_CONTENT_TITLE"	"Posiada jeden z przedmiotów"
"GAMEPLAY_Brawl_NewYear"	"Świąteczny napad"
"GAMEPLAY_FreePlay_Pvp_Name"	"Bedlam"
"GARAGE_ERROR_NO_DECAL"	"Brak naklejki w magazynie"
"GARAGE_ERROR_NO_DECAL_TIP"	"Brak naklejek tego typu, zakup na markecie lub stwórz dodatkowe egzemplarze"
"GARAGE_LEVIATHAN_UNKNOWN"	"NIEDOSTĘPNY"
"GOLD_PACK_150_GOLD_Name"	"Paczka 150 Monet"
"GOLD_PACK_2500_GOLD_Name"	"Paczka 2500 monet"
"GOLD_PACK_3500_GOLD_Name"	"Paczka 3500 monet"
"Greatescape_psycho_caption"	"Lina"
"HANGAR_TAB_FUSION_TOOLTIP"	"Pewne części mogą być ulepszone z pomocą innych części"
"HUD_DETACH_HARPOON_TITLE"	"Pojazd zaczepiony przez harpun!"
"item_Chest_online_2h_gold_Name"	"Kontener wędrowca"
"item_chest_paints_craft_desc"	"Produkuje losową skrzynkę z farbą"
"item_chest_skins_col1_2_name"	"Paczka złotej rączki"
"item_chest_skins_col1_name"	"Paczka Artysty"
"item_chest_skins_craft_desc"	"Produkuje losowy kontener z zestawem kustomizacji"
"Keepheist_psycho_caption"	"Joker"
"LEVIATHAN_HINT_TITLE1"	"Zbuduj swojego behemota!"
"MAP_DESC_POWERPLANT_NEWYEAR"	"Kryjówka Groncha"
"mask_ambulance_name"	"Mortus"
"Mask_Boar_name"	"Jager"
"Mask_DLC_1_name"	"Air Shaman"
"Mask_DLC_2_name"	"Wotan"
"Mask_DLC_tank_name"	"Tankman"
"Mask_Frenzied_1_name"	"Munch"
"Mask_Frenzied_2_name"	"Lina"
"Mask_Frenzied_3_name"	"Joker"
"Mask_Halloween_2017_1_name"	"Dr. Hyde"
"Mask_Mechanics_1_name"	"Foxy"
"Mask_Mechanics_2_name"	"Jones"
"Mask_Military_1_name"	"Elvina"
"Mask_Military_2_name"	"Gunther"
"Mask_Military_3_name"	"Tomasz"
"Mask_military_bundle_1_name"	"Spider"
"Mask_PSN_Exclusive_pack_name"	"Hunter"
"Mask_Scavengers_1_name"	"Dozer"
"Mask_Scavengers_2_name"	"Owl"
"Mask_Scavengers_3_Desc"	"Prawie umarł w płonącym aucie, strasznie poparzony. Teraz jest zawsze zimny z powodu ekstremalnych oparzeń, niezastąpiony ze spawarką, może patrzeć na słońce bez mrugania."
"Mask_Scavengers_3_name"	"Thermite"
"Mask_Scientists_1_name"	"Rocket"
"Mask_Scientists_2_name"	"Spike"
"Mask_Scientists_3_name"	"Daedalus"
"Mask_scientists_bundle_1_name"	"Lloyd"
"Mask_Steam_name"	"Aleph"
"Mask_Traders_1_name"	"Jeff"
"Mask_Valentine2018_name"	"Bonnie"
"nomads_Boss_hard_name"	"Nomad"
"Oilevac_nomads_caption"	"Zero"
"PARTTYPE_70_20_Decals"	"Naklejka"
"Restriction_RESOURCE_NewYearMoney_Name"	"Brak odpowiedniej ilości petard"
"SEASON_QUEST_LOCK_FACTION_ANY"	"Wymagany poziom reputacji $lvl$ z zaawansowaną frakcjąfactions"
"SETTING_gamepadLayout1_desc"	"Do kontroli pojazdu użyj lewego \"sticka\""
"SETTING_gamepadLayout3_desc"	"Dla tych którzy kochają symulatory wyścigowe"
"ShopWnd_recommended"	"Rekomendowane"
"CarPart_Gun_ShotGun_Garbage_name"	"Junkbow"
"PARTTYPE_20_11_AutoWeapon"	"Broń automatyczna"
"PERK_Chassis_Shnek_DESC"	"Pozwala na poruszanie się bokiem, zadaje obrażenia wrogim pojazdom"
"PERK_Course_Cabin_DESC"	"Obrażenia broni o limitowanym kącie obrotu zwiększone o|$nonrotated_weapon_Damage_mul$%."
"PERK_Firing_Resists_DESC"	"Posiada zwiększoną wytrzymałość.|Zdolność ta jest nie aktywna podczas strzelania"
"pic_RussianFolk01_Name"	"Północna Opowieść"
"pic_YouTube03_Name"	"Jedność Graczy"
"brawl_Boss_main"	"Grinch"
"Cancel"	"Odwołaj"
"EventNotificationWnd_craftsman"	"Produkcja"
"gameplay_newyear_hint_2"	"Pojazd Grincha posiada słaby punkt! musisz go znaleźć."
"psycho_Boss_easy_name"	"Scarecrow"
"psycho_Boss_hard_name"	"Mayhem"
"psycho_Boss_medium_name"	"Sketch"
"PunishReason_CaptchaFailed"	"Nie poprawny tekst z obrazka"
"scavengers_Boss_hard_name"	"Hulk"
"scavengers_Boss_medium_name"	"Smasher"
"Starter_pack_thai_Desc"	"Kontener zawierający części, od kabin do broni, wszystko co pomoże w kreacji twojego wymarzonego pojazdu|Dziękujemy za osiągnięcie 5 poziomu reputacji! im dalej tym lepiej!"
"TCWnd_title"	"Wybór schematu kontroli"
"UserBlueprintWnd_buy"	"Kup za"
"xmas_bundle_Vehicle_Name"	"Icebreaker"
"RESOURCE_TYPE_FirestartersMoney"	"Zapalniczki"
"RESOURCE_TYPE_NewYearMoney"	"Petardy"
"MissionWnd_Brawl_successful_battles"	"Wygrane bitwy: $val$/$max$"
"MissionWnd_event_reward_NewYearMoney"	"Petardy||Wymagane do zakupu kontenera z prezentami"
"Mission_Brawl_Newyear_Name"	"Świąteczny Napad"
"xmas_mini_Vehicle_bound_Name"	"Zdobądź Jodłę"
"xmas_mini_Vehicle_Name"	"Zdobądź Jodłę"
"SETTING_gamepadLayout_BreakBackward"	"Hamulec, wstecz"
