"achievement_LVL_FACTION_FIRESTARTERS_name"	"Pyromancer"
"achievement_LVL_PARAGON_FIRESTARTERS_name"	"Z patelni na ogień"
"ADVENTURE_REWARD_EXP"	"Reputacja"
"ambulance01_bundle_vehicle_desc"	"Ambulans który Mortus używał do transportu chorych przez wiele lat, okazał się bardzo przydatny nawet po katastrofie, wygląd jak i przeznaczenie zmieniło się aby bardziej odpowiadać wymaganiom właściciela, pojazd stał się zwiastunem śmierci na pustkowiach, nawet zauważony z dystansu przepowiada o zgubie, jeśli dobry doktor usłyszy wołania o pomoc, nie oszczędza nikogo, więc milcz! nie ważne jak bardzo boli."
"ambulance01_bundle_vehicle_name"	"Ostatnia pomoc"
"avatar_default_name"	"Kai"
"Blockpost_Defeat_psycho_text"	"Raz, dwa, trzy, cztery - I już gryzą glebe!"
"Blockpost_Defeat_psycho_text3"	"Raz, dwa, i go nie ma!"
"Blockpost_Defeat_scavengers_text"	"Dostałeś po łapach? zabieranie naszego towaru to czysta głupota!"
"Blockpost_Defeat_scavengers_text2"	"Było nasze, wasze, a teraz znowu nasze. Ha! nie zabieraj tego co nie twoje!"
"Blockpost_Post1_nomads_text"	"Zatrzymać się i odłorzyć broń, jeszcze coś sobie zrobicie..."
"Blockpost_Post1_scavengers_text"	"Jesteś głuchy czy głupi? Gdzie jedziesz!? Oddawaj ten pojazd!"
"Blockpost_Post1_scavengers_text2"	"Ahem... tutaj Dozer, własnie tutaj się zatrzymujesz."
"Blockpost_Post2_nomads_text2"	"Praktyka czyni cuda co? Dobra, pokazuj drugi bok, poćwiczymy więcej."
"Blockpost_Post2_psycho_text3"	"Drugi obóz miał : Króla, Królową i Księcia... I SZKIELETY TYCH KTÓRZY TU PRZYSZLI!"
"Blockpost_Post3_psycho_text"	"Scar, Scar, Scar AB, znaczy wszyscy PRZESTAJECIE ISTNIEĆ!"
"Blockpost_Post3_psycho_text2"	"Pięć, cztery, trzy, dwa, jeden... Teraz jak nauczyłeś się liczyć. Nie wiemy co jeszcze powiedzieć... może rozwal tego jegomościa?"
"Blockpost_scavengers_caption"	"Dozer"
"Blockpost_Start_nomads_text"	"Pokój z tobą! transport który eskortujesz jest w posiadaniu Nomadów, nalegam abyście go oddali bez walki."
"Blockpost_Start_nomads_text3"	"Powiedz... ile ci zapłacili za tą eskorte?  zaoferował bym wiecej. Ale nie mam zamiaru dobijać targu ze złodziejami."
"Blockpost_Start_psycho_text"	"Odwarzni, zabierają nasz towar! WALIĆ DO WSZYSTKIEGO CO SIE RUSZA!"
"Blockpost_Start_scavengers_text3"	"No, to co my tu mamy? Ukradziony towar! Zatrzymuj się! puki jeszcze masz czym naciskać na pedały"
"Blockpost_Win_nomads_text2"	"J... Jak?... Jak to sie stało?"
"Blockpost_Win_nomads_text3"	"Nieeee, przegraliśmy! powiedzcie mojej rodzinie że..."
"Blockpost_Win_psycho_text"	"Baaargh! Dobra! wygrałeś! zabije kogoś innego!"
"Blockpost_Win_psycho_text2"	"Dobra zabawa! szkoda tylko że to my oberwaliśmy..."
"Blockpost_Win_psycho_text3"	"Złapałeś kule - idziesz do domu, to wszystko!"
"Blockpost_Win_scavengers_text2"	"Przegraliśmy. cholera!"
"Blockpost_Win_scavengers_text3"	"Dobra, dobra! Wygrałeś! ale tylko ten raz, łapiesz?"
"BLUEPRINT_EXHIBITION_TOOLTIP"	"Podziel się schematem pojazdu na wystawie, niechaj inni ocenią oraz skopiują twoją kreacje"
"BLUEPRINT_LOAD_TOOLTIP"	"Złóż pojazd bojowy z części dostępnych w magazynie"
"boar_bundle_vehicle_name"	"Boar"
"Bombrun_Boss_psycho_text3"	"Jasny gwint! ciągle myślę że to prezent, kłamliwe węże! jakim cudem jeszcze żyjecie!? złamaliście mi serce, ja złamie wasze gęby!"
"Bombrun_Def_psycho_text2"	"Chłopaki, to jest pompa olejowa. Nie wolno tutaj parkować wybuchowych ciężarówek. Czekaj... jaki macie plan? zwariowaliście?! niech no was tylko dopadnę!"
"Bombrun_nomads_caption"	"Jeff"
"Bombrun_scavengers_caption"	"Thermite"
"Bombrun_Start_psycho_text2"	"Hej, co to za przyjemny dźwięk? czy to jest zaminowany pojazd? Naprawdę, nie musieliście chłopaki! to nawet nie są moje urodziny!"
"Bombrun_Win_nomads_text2"	"Wygraliście. Muszę przyznać, nie tego się spodziewałem."
"Bombrun_Win_psycho_text"	"Ha-ha! Wygląda na to że się przepracowaliśmy?!"
"Bombrun_Win_psycho_text3"	"No to było solidne BOOM! Wiem że to nas wywalili w powietrze, ale rąbneło solidnie!"
"Bombrun_Win_scavengers_text3"	"Nie! Nie! Nie mogliście wygrać!"
"BRIEFING_WAIT_OTHER_PLAYERS"	"Oczekiwanie na innych graczy"
"Bundle_Landing_cabin_Name"	"Specjalny podarunek"
"Bundle_Landing_weapon_Name"	"Specjalny podarunek"
"Cabin_DronSpawn_name"	"Werewolf"
"Cabin_Tribal_Hog_Name"	"Tusk"
"Captcha_text_2"	"Pozostało prób: $val$."
"CarDriver_Firestarters_lvl10_desc"	"Obrażenia od ognia zwiększone o $car_damage_flame_mul$%"
"CarDriver_Firestarters_lvl12_name"	"Jednostrzał 3"
"CarDriver_Firestarters_lvl13_desc"	"$targets$: amunicja +$ammo_add$ pcs."
"CarDriver_Firestarters_lvl14_name"	"Druga szansa"
"CarDriver_Firestarters_lvl2_name"	"Jednostrzał 1"
"CarDriver_Firestarters_lvl4_desc"	"$targets$: Przeładowanie przyspieszone o $shooting_cooldown_mul$%"
"CarDriver_Firestarters_lvl5_name"	"Zapalniczka"
"CarDriver_Firestarters_lvl7_name"	"Jednostrzał 2"
"CarPart_Fireworks_Dragon_Name"	"Ukryty Smok"
"CarPart_Fireworks_Valentine_Name"	"Fioletowe fajerwerki"
"CarPart_Gun_catapult_name"	"Incinerator"
"CarPart_Gun_Flamethrower_fixed_name"	"Draco"
"CarPart_Gun_WheelRocket_name"	"Fortune"
"CarPart_SelfCalc_name"	"Tormentor"
"CarPart_Shnekohod_Desc"	"Zadziwiąjący sposób transportu, dwie śróby stworzone przez pewnego Archimedesa, każda śróba zmniejsza siłę kabiny ale pozwala na poruszanię się bokiem."
"CarPart_Structure_bumper1_name"	"Nibbler"
"CarPart_Structure_fender3_l_Desc"	"Przedni lewy błotnik hot-roda. Wygląda niebezpiecznie. Nie dotykać!"
"CarPart_Structure_fender3_l_name"	"Lewy róg"
"CarPart_Structure_fender3_r_name"	"Prawy róg"
"CarPart_Structure_radiator_grill2_name"	"Boar"
"CarPart_Wheel_Hopping_name"	"Stallion"
"CarPart_Wheel_MonsterTruck_name"	"Bigfoot"
"Chase_Defeat_nomads_text2"	"Moje zwycięstwo to była kwestia czasu!"
"Chase_Defeat_scavengers_text"	"Zwycięstwo jest twoje!"
"Chase_Defeat_scavengers_text3"	"I kto jest teraz złomem? masz dosyć?"
"Chase_FirstNPCKill_scavengers_text3"	"Jesteśmy atakowani! Naprzód!"
"CHAT_PUNISHED_player_ban"	"$accusedNickname$ został zablokowany za $reason$ do $until$ UTC."
"CHAT_PUNISHED_player_mute"	"$accusedNickname$ został wyciszony za $reason$ do $until$ UTC."
"ChestOpen_accept"	"Odbierz"
"ChestOpen_reroll"	"Zwróć za $cost$"
"ChestOpen_reroll_confirmation"	"Czy na pewno chcesz losować inną nagrodę?"
"China_NY_Wins_desc"	"Wygraj 5 bitew w Najazdach lub Misjach."
"China_NY_Wins_name"	"Moon Knight"
"Commtowers_Defeat_psycho_text3"	"Tak oto spoko goście robią rzeczy!"
"Commtowers_psycho_caption"	"Munch"
"Craftsman_FirestartersLegend_Name"	"Podziemny skarbiec"
"Craftsman_FirestartersRare_Name"	"Old pantry"
"Decal_23feb2018_bear_name"	"Z tarczą lub na niej."
"Decal_23feb2018_star_Name"	"Skrzydła zwycięstwa"
"Decal_23feb2018_wolf_Name"	"Obrońca ojczyzny"
"Decal_8march01_Name"	"Brave Heart"
"Decal_bear01_name"	"Ryk niedźwiedzia."
"Decal_china_fu_Name"	"Życz mi szczęscia"
"Decal_eagle_tank_name"	"Lot orła"
"Decal_engineer01_Name"	"Siła robocza"
"Decal_fire_14feb2018_Name"	"Szybki i martwy"
"Decal_hog01_name"	"Oko bestii"
"Decal_japan_contest2018_boar_name"	"Wild Boar"
"Decal_japan_contest2018_samurai_duck_name"	"Bojowa kaczuszka"
"Decal_nyear2018_bow_Name"	"Wstęga"
"Decal_tribal02_Name"	"Asmodeus"
"Decal_tribal03_Name"	"Belial"
"Decal_tribal04_Name"	"Flauros"
"driverswnd_skills"	"Umiejętności:"
"Driver_Firestarters_Name"	"Misty"
"Dye_Valentine2018_Name"	"Lolipop"
"ERROR_ANOTHER_CHEST_OPENED"	"Inna skrzynka zostałą otwarta, proszę odebrać jej zawartość"
"ERROR_NO_CHEST_OPENED"	"Próba losowania nie powiodła się, skrzynka nie jest jeszcze otwarta"
"ERROR_NO_REROLL_COST"	"Brak dodatkowych prób losowania nagrody."
"ERROR_WRONG_ROLL_COUNT"	"Brak dodatkowych prób losowania nagrody."
"EventNotificationWnd_quests"	"Gotowe zadania"
"event_notification_title_NEW_YEAR"	"Wesołych świąt!"
"EXHIBITION_HAVE_PARTS"	"Można zbudować"
"Exploration_Cargo_name"	"Ładunek"
"Exploration_Message_DropLoot_name"	"Wrak"
"Exploration_Message_PatrolEvent_name"	"Patrol"
"Exploration_PublicQuest_Convoy_Name"	"Konwój"
"Exploration_PublicQuest_Defense_Name"	"Obrona"
"Exploration_Quest_Survey3_Name"	"Zbieranie danych"
"FACTION_CRAFT_CHEST_CONTENT"	"Możliwa zawartość"
"FACTION_CRAFT_CHEST_CONTENT_TITLE"	"Posiada jeden z przedmiotów"
"firestarter_bundle_Vehicle_Name"	"Wild Fire"
"FMA_USER_PROFILE"	"Zobacz kartę statystyk gracza"
"GAMEPLAY_Brawl_NewYear"	"Świąteczny napad"
"GAMEPLAY_FreePlay_Pvp_Name"	"Bedlam"
"GAMEPLAY_Pve_Oilevac"	"Bitwa o ogień"
"GARAGE_ERROR_NO_DECAL"	"Brak naklejki w magazynie"
"GARAGE_ERROR_NO_DECAL_TIP"	"Brak naklejek tego typu, zakup na markecie lub stwórz dodatkowe egzemplarze"
"GARAGE_LEVIATHAN_UNKNOWN"	"NIEDOSTĘPNY"
"Giveaway_saturation_drivers"	"Kierowcy:"
"GOLD_PACK_150_GOLD_Name"	"Paczka 150 Monet"
"GOLD_PACK_2500_GOLD_Name"	"Paczka 2500 monet"
"GOLD_PACK_3500_GOLD_Name"	"Paczka 3500 monet"
"Greatescape_Cargo_psycho_text3"	"Słyszałeś kiedyś że kradzież jest ZŁA!? Czekaj tylko podjadę bliżej i ci wytłumaczę!"
"Greatescape_nomads_caption"	"Jean"
"Greatescape_psycho_caption"	"Lina"
"Greatescape_Start_scavengers_text3"	"Hej! Chcesz zabierać nasze rzeczy!? Jasne, możesz próbować!"
"Greatescape_Win_nomads_text2"	"Przegraliśmy, przyznaję."
"Greatescape_Win_nomads_text3"	"To już koniec, przynajmniej próbowaliśmy."
"HANGAR_TAB_EXHIBITION_CAN_BUILD"	"Można zbudować"
"HANGAR_TAB_FUSION_TOOLTIP"	"Pewne części mogą być ulepszone z pomocą innych części"
"HANGAR_TAB_SHOP_PREMIUM"	"Skannery"
"HUD_DETACH_HARPOON_TITLE"	"Pojazd zaczepiony przez harpun!"
"HUD_EVENT_ACT_SUDDENDEATH_STOP"	"Czas rozwalić kilka pojazdów!"
"HUD_PVE_CAPTURE_CAR"	"Odebrać ciężarówkę!"
"item_Chest_online_2h_gold_Name"	"Kontener wędrowca"
"item_chest_paints_craft_desc"	"Produkuje losową skrzynkę z farbą"
"item_chest_skins_col1_2_name"	"Paczka złotej rączki"
"item_chest_skins_col1_name"	"Paczka Artysty"
"item_chest_skins_craft_desc"	"Produkuje losowy kontener z zestawem kustomizacji"
"Keepheist_psycho_caption"	"Joker"
"LEVIATHAN_HINT_TITLE1"	"Zbuduj swojego behemota!"
"MAP_DESC_POWERPLANT_NEWYEAR"	"Kryjówka Groncha"
"mask_ambulance_name"	"Mortus"
"Mask_Boar_name"	"Jager"
"Mask_DLC_2_name"	"Wotan"
"Mask_DLC_tank_name"	"Tankman"
"Mask_Firestarters_1_name"	"Vesuvius"
"Mask_Firestarters_3_name"	"Sangay"
"Mask_Frenzied_1_name"	"Munch"
"Mask_Frenzied_2_name"	"Lina"
"Mask_Frenzied_3_name"	"Joker"
"Mask_Halloween_2017_1_name"	"Dr. Hyde"
"Mask_Mechanics_1_name"	"Foxy"
"Mask_Mechanics_2_name"	"Jones"
"Mask_Military_2_name"	"Gunther"
"Mask_Military_3_name"	"Tomasz"
"Mask_military_bundle_1_name"	"Spider"
"Mask_PSN_Exclusive_pack_name"	"Hunter"
"Mask_ratking_name"	"Król szczórów"
"Mask_Scavengers_1_name"	"Dozer"
"Mask_Scavengers_2_name"	"Owl"
"Mask_Scavengers_3_name"	"Thermite"
"Mask_Scientists_1_name"	"Rocket"
"Mask_Scientists_2_name"	"Spike"
"Mask_Scientists_3_name"	"Daedalus"
"Mask_scientists_bundle_1_name"	"Lloyd"
"Mask_Starter_pack_name"	"Vicky"
"Mask_Traders_1_name"	"Jeff"
"Mask_Xmas2017_bundle_name"	"Jack Frost"
"MBP_RatKing_caption"	"Król szczórów"
"MBP_RatKing_firstBlood_text4"	"Dobry start!"
"nomads_Boss_hard_name"	"Nomad"
"Oilevac_nomads_caption"	"Zero"
"Oilevac_Win_nomads_text3"	"Zaklinam was! Mam nadzieje że dostaniecie gorączki!"
"Oilevac_Win_psycho_text"	"Siedem piekieł! przegraliśmy!"
"Oilevac_Win_scavengers_text3"	"Znikneli z naszą benzyną... cholera..."
"PARTS_ACTIVATE_PREMIUM"	"Zacznij Skanowanie"
"PARTTYPE_20_54_Catapult"	"Katapulta"
"PARTTYPE_decoration_banner"	"Flaga"
"Premium_1d_Name"	"Skanner ( Aktywny przez 1 dzień)"
"Premium_3d_Name"	"Skanner (Aktywny przez 7 dni)"
"Premium_7d_Name"	"Skanner (Aktywny przez 7 dni)"
"PROFILE_STATS_RARITY_COMMON"	"Pospolity"
"PROFILE_STATS_RARITY_EXOTIC"	"Relikt"
"PROFILE_STATS_RARITY_LEGENDARY"	"Legendarny"
"PROFILE_STATS_RARITY_RARE"	"Rzadki"
"QUESTWND_NO_SEASON_TITLE"	"Sezon nie aktywny"
"Quest_23feb_15_name"	"Za Honor"
"Quest_8march05_name"	"W imię miłości"
"Restriction_RESOURCE_NewYearMoney_Name"	"Brak odpowiedniej ilości petard"
"SEASON_QUEST_LOCK_FACTION_ANY"	"Wymagany poziom reputacji $lvl$ z zaawansowaną frakcjąfactions"
"SETTING_Colors"	"Kolor Znacznika"
"SETTING_Color_Enemy"	"Wróg"
"SETTING_gamepadLayout1_desc"	"Do kontroli pojazdu użyj lewego \"sticka\""
"SETTING_gamepadLayout3_desc"	"Dla tych którzy kochają symulatory wyścigowe"
"SETTING_SYNC_INTERVAL_2"	"Włączony (1/2 Częstotliwość odświerzania)"
"ShopPremium_premium_not_active"	"@ffffa000Skanner nie aktywny"
"ShopWnd_recommended"	"Rekomendowane"
"ShopWnd_Temporary"	"Ostatnia szansa"
"TutorialBaseFactionLevel_2_Name"	"Poziom Inżynierów"
"TutorialBaseFactionLevel_4_Name"	"Poziom Inżynierów"
"TutorialPveEasyWin_1_Name"	"Zwycięstwo na rajdzie"
"TutorialPveHardWin_1_Name"	"Zwycięstwo na rajdzie"
"TutorialPveMediumWin_1_Name"	"Zwycięstwo na rajdzie"
"TutorialPvpWin_1_Name"	"Zwycięstwo na misji"
"TutorialPvpWin_3_Name"	"Zwycięstwo na misji"
"TutorialPvpWin_4_Name"	"Zwycięstwo na misji"
"TutorialSellScrap_1_Name"	"Sprzedawanie złomu"
"valentine_18_bundle_Vehicle_Name"	"Skoczny kucyk"
"ADVENTURE_REWARD_TITLE"	"Nagroda:"
"Cabin_DronSpawn_Desc"	"z taką kabiną, przegrana możę się zamienić w zwycięstwo! i nie obawia się srebrnych kul"
"CarPart_Gun_ShotGun_Garbage_name"	"Junkbow"
"Decal_raider05_Name"	"Padlinożerca"
"PARTTYPE_20_11_AutoWeapon"	"Broń automatyczna"
"PARTTYPE_70_20_Decals"	"Naklejka"
"PERK_Chassis_Shnek_DESC"	"Pozwala na poruszanie się bokiem, zadaje obrażenia wrogim pojazdom"
"PERK_Course_Cabin_DESC"	"Obrażenia broni o limitowanym kącie obrotu zwiększone o|$nonrotated_weapon_Damage_mul$%."
"PERK_Firing_Resists_DESC"	"Posiada zwiększoną wytrzymałość.|Zdolność ta jest nie aktywna podczas strzelania"
"pic_RussianFolk01_Name"	"Północna Opowieść"
"pic_YouTube03_Name"	"Jedność Graczy"
"brawl_Boss_main"	"Grinch"
"bundle_Zubilo_Vehicle_Name"	"Zabijaka"
"Cancel"	"Odwołaj"
"CarDriver_Firestarters_lvl12_desc"	"$targets$: Obrażenia +$damage_mul$%"
"CarDriver_Firestarters_lvl7_desc"	"$targets$: obrażenia +$damage_mul$%"
"CarDriver_Military_lvl11_desc"	"$targets$: Obrażenia +$damage_mul$%"
"CarDriver_Military_lvl14_name"	"Ekspert"
"CarDriver_Military_lvl1_desc"	"$targets$: Obrażenia +$damage_mul$%"
"CarDriver_Military_lvl6_desc"	"$targets$: Obrażenia +$damage_mul$%"
"EventNotificationWnd_craftsman"	"Produkcja"
"format_hours_short"	"g."
"format_minutes_short"	"min."
"gameplay_newyear_hint_2"	"Pojazd Grincha posiada słaby punkt! musisz go znaleźć."
"HANGAR_TAB_SHOP_APPEARANCE"	"Wygląd "
"Mask_Bei_desc"	"Kolekcjoner"
"Mask_DLC_1_name"	"Air Shaman"
"Mask_Military_1_name"	"Elvina"
"Mask_Scavengers_3_Desc"	"Prawie umarł w płonącym aucie, strasznie poparzony. Teraz jest zawsze zimny z powodu ekstremalnych oparzeń, niezastąpiony ze spawarką, może patrzeć na słońce bez mrugania."
"Mask_Steam_name"	"Aleph"
"Mask_Valentine2018_name"	"Bonnie"
"psycho_Boss_easy_name"	"Scarecrow"
"psycho_Boss_hard_name"	"Mayhem"
"psycho_Boss_medium_name"	"Sketch"
"PunishReason_CaptchaFailed"	"Nie poprawny tekst z obrazka"
"scavengers_Boss_hard_name"	"Hulk"
"scavengers_Boss_medium_name"	"Smasher"
"Starter_pack_thai_Desc"	"Kontener zawierający części, od kabin do broni, wszystko co pomoże w kreacji twojego wymarzonego pojazdu|Dziękujemy za osiągnięcie 5 poziomu reputacji! im dalej tym lepiej!"
"TCWnd_title"	"Wybór schematu kontroli"
"UserBlueprintWnd_buy"	"Kup za"
"xmas_bundle_Vehicle_Name"	"Icebreaker"
"RESOURCE_TYPE_FirestartersMoney"	"Zapalniczki"
"RESOURCE_TYPE_NewYearMoney"	"Petardy"
"Blockpost_Defeat_nomads_text3"	"Przekarzę tragiczne wiadomości o twoim zgonie twojej rodzinie... nic sie nie martw."
"Blockpost_psycho_caption"	"Lewis"
"MissionWnd_Brawl_successful_battles"	"Wygrane bitwy: $val$/$max$"
"MissionWnd_event_reward_NewYearMoney"	"Petardy||Wymagane do zakupu kontenera z prezentami"
"Mission_Brawl_Newyear_Name"	"Świąteczny Napad"
"xmas_mini_Vehicle_bound_Name"	"Zdobądź Jodłę"
"xmas_mini_Vehicle_Name"	"Zdobądź Jodłę"
"SETTING_Control"	"Sterowanie"
"SETTING_Game"	"Gra"
"SETTING_GamepadGeneral"	"Ogólne"
"SETTING_gamepadLayout_BreakBackward"	"Hamulec, wstecz"
"SETTING_GeneralGame"	"Gra"
"SETTING_tab_GAME"	"Gra"
"SETTING_tab_GENERAL"	"Ogólne"
"SETTING_UiColors"	"Kolor Znacznika"
"story_item_generator_q01_name"	"Generator"
"story_item_lloyd_Thing_name"	"Czujnik"
"story_message_generator_q01_desc"	"Generator"
"story_message_generator_q01_name"	"Generator"
"story_title_signal_name"	"Sabotaż"
"story_title_stoned_name"	"Polowanie na Łowcę"
"story_title_traitor_name"	"Chrzest bojowy"
"story_title_Trap1_name"	"Przynęta"
